111111111111
1C00C0000001
100P0000C001
1C00000E00C1
111111111111