1111111111
1000C00001
1111000011
1C00000EC1
1000000011
10P0C00001
1111111111