1111111111
1P00C11101
1110111101
1C10000E01
1111111111